12 18
3 1
WGGGGGGGGWGGGGWAWW
WFFFCDCFCDCFFTTFFW
WFFFFFFFFFFFFFFFFW
ASSFFFFFFFFFFFSSSB
ASSFFFFFFFFFFFSSSB
WFFFFFFFFFFFFFFFFW
WFFFCDCFFFFFCDCFFW
WFFFFFFFCDCFFFFFFW
WFFFCDCFFTFFCDCFFW
WFFFFFFFFFFFFFFFFW
WFTTTTTTTTTTTTTTFW
WWWWWWWWWWWWWWWWWW