12 18
3 1
WGGGGGGGGWGGGGWAWW
WFFFCDCFCDCFFTTFFW
WFFFFFFFFFFFFFFFFW
ASSFFFFFFFFFFFSSSA
ASSFFFFFFFFFFFSSSA
WFFFFFFFFFFFFFFFFW
WFFFCDCFFFFFCDCFFW
WFFFFFFFCDCFFFFFFW
WFFFCDCFFTFFCDCFFW
WFFFFFFFFFFFFFFFFW
WFTTTTTTTTTTTTTTFW
WWWWWWWWWWWWWWWWWW