12 16
10 7
WWWWWWWWWWWWWWWW
WFFFFFFTTEFFFFFW
WFFFFFFDDFFFFFFW
WFFFFFFFFFFFFFFW
WRDDDDDRRDDDDDRW
WRTTTTTRRTTTTTRW
WRDDDDDRRDDDDDRW
WRTTTTTRRTTTTTRW
WRDDDDDRRDDDDDRW
WRTTTTTRRTTTTTRW
WFFFFFFFFFFFFFFW
WWWWWWWAAWWWWWWW