12 16
1 7
WWWWWWWHHWWWWWWW
WWWWWWAFFAWFSEWW
WWWWWWWFFWWRWWWW
WWWWWWWFFFFFFFFG
WWWWWWWFFWWWWWWW
WWWWFFFFFFFFWWWW
WWWAFFFFFFFFAWWW
WWWWFFFFFFFFWWWW
WWWWFFFFFFFFWWWW
WWWAFFFFFFFFAWWW
WWWWFFFFFFFFWWWW
WWWWGGGGGGGGWWWW