12 16
2 1
WWWWWWWWWWWWWWWW
BFFFFFFFFTTFFFEG
BFFFFFFFFFFFFFFG
WFFFFFFFFFFFFFFG
WWWWWWWFFWWWWWWW
WWWWWWAFFAWWWWWW
WWWWWWWFFWWWWWWW
WWWWWWWFFWWWWWWW
WWWWWWAFFAWWWWWW
WWWWWWWFFWWWWWWW
WWWWWWWFFWWWWWWW
WWWWWWAHHAWWWWWW