7 18
2 1
WWWWWWWWWWWWWWWWWW
WFFFFFFFFFFFFFFFFW
AFFFDFFFFDFFDFFFFW
WFFFDFFFDFDFDFFFFW
WFFFDDDFFDFFDDDFFW
WFFFFFFFFFFFFFFFFW
WWWWWWWWWWWWWWWWWW